atm	A T M
Atm	A T M
ATM	A T M
B2B	B to B
cba	C B A
CBA	C B A
cctv	C C T V
CCtv	C C T V
CD	C D
ceo	C E O
CEO	C E O
cpu	C P U
CPU	C P U
dv	D V
DV	D V
EQ	E Q
gps	G P S
GPS	G P S
gpu	G P U
GPU	G P U
iq	I Q
IQ	I Q
kfc	K F C
KFC	K F C
mba	M B A
MBA	M B A
ms	M S
mv	M V
MV	M V
mvp	M V P
M.V.P	M V P
MVP	M V P
nba	N B A
Nba	N B A
NBA	N B A
O2O	O to O
P2P	P to P
pc	P C
PC	P C
qq	Q Q
Qq	Q Q
QQ	Q Q
ufo	U F O
Ufo	U F O
UFO	U F O
vip	V I P
VIP	V I P
wto	W T O
WTO	W T O
xL	X L
XL	X L
xxL	X X L
XXL	X X L
xxxL	X X X L
XXXL	X X X L
